1111111111111111111111111
1PCCCCCCCCCCCCCCCCCCCCCC1
1C0000000000C0000000000C1
1C0000000000C0000000000C1
1CCCCCCCCCCCCCCCCCCCCCCC1
1C0000000000C0000000000C1
1C0000000000C0000000000C1
1C0000000000C0000000000C1
1CCCCCCCCCCCECCCCCCCCCCC1
1C0000000000C0000000000C1
1C0000000000C0000000000C1
1C0000000000C0000000000C1
1CCCCCCCCCCCCCCCCCCCCCCC1
1C0000000000C0000000000C1
1C0000000000C0000000000C1
1CCCCCCCCCCCCCCCCCCCCCCC1
1111111111111111111111111