1111111111111111111111111
1PCCCCCCCCCCCCCCCCCCCCCC1
1C1111111111C1111111111C1
1C1111111111C1111111111C1
1CCCCCCCCCCCCCCCCCCCCCCC1
1C1111111111C1111111111C1
1C1111111111C1111111111C1
1CCCCCCCCCCCECCCCCCCCCCC1
1C1111111111C1111111111C1
1C1111111111C1111111111C1
1CCCCCCCCCCCCCCCCCCCCCCC1
1C1111111111C1111111111C1
1C1111111111C1111111111C1
1CCCCCCCCCCCCCCCCCCCCCCC1
1111111111111111111111111