1111111111111111111111111
1PCCCXCCCCCCCCCCCCCCCCCC1
1C1111111111C1111111111C1
1C1111111111C1111111111C1
1CCCCCCCCCCCCCCCCCCCCCCC1
1C1111111111C1111111111C1
1C1111111111C1111111111C1
1CCCCCCCCCCCECCCCXCCCCCC1
1C1111111111C1111111111C1
1C1111111111C1111111111C1
1CCXCCCCCCCCCCCCCCCCCCCC1
1C1111111111C1111111111C1
1C1111111111C1111111111C1
1CCCCCXCCCCCCCCCCCCCCCCC1
1111111111111111111111111