1111111111111111111111111
1PCCCCCCXCCCCCCCCCCCCCCC1
1C0000000000C0000000000C1
1C0000000000C0000000000C1
1CCCCCCCCCCCCCCCCCCCCCCC1
1C0000000000C0000000000C1
1C0000000000C0000000000C1
1C0000000000C0000000000C1
1CCCCCCCXCCCECCCCCCCCCCC1
1C0000000000C0000000000C1
1C0000000000C0000000000C1
1C0000000000C0000000000C1
1CCCCCCCXCCCCCCCCCCCCCCC1
1C0000000000C0000000000C1
1C0000000000C0000000000C1
1CCCCXCCCCCCCCCCCCCCCCCC1
1111111111111111111111111