1111111111111
10X10000000C1
100001111X001
1P0011E000001
1111111111111
